The first witnessing of echidnas
5 7
 0 0 0 0 0 0 0 0 0 0 0 0 0 0 0 0 0 0 0 0
 0 1 1 1 1 1 1 1 1 1 1 1 0 0 0 0 0 0 0 0
 0 1 0 0 0 0 0 0 1 1 1 1 1 1 1 1 1 1 0 0
 0 1 0 0 0 0 0 0 1 1 1 1 0 0 0 0 0 1 0 0
 0 1 0 0 0 0 0 0 1 1 1 1 0 0 0 0 0 1 0 0
 0 1 0 0 0 0 0 0 0 0 0 0 0 0 0 0 0 1 1 0
 0 1 0 0 1 1 1 0 0 0 0 0 0 1 1 1 0 1 1 0
 0 1 0 0 1 1 114 1 1 1 1 1 1 3 1 0 1 1 0
 0 1 0 0 1 1 1 0 0 0 0 0 0 1 1 1 0 1 1 0
 0 1 0 0 0 0 0 0 0 0 0 0 0 0 0 0 0 1 1 0
 0 1 0 0 0 0 0 0 012 1 1 0 0 0 0 0 1 1 0
 0 1 0 0 0 0 0 0 0 1 1 1 0 0 0 0 0 0 1 0
 0 1 0 0 0 0 0 0 0 0 0 1 0 0 0 0 0 0 1 0
 0 1 1 1 1 1 1 1 1 1 1 1 1 1 1 1 1 1 1 0
 0 0 0 0 0 0 0 0 0 0 0 0 0 0 0 0 0 0 0 0

11 1 3
9 3 0
