The final level.  ALMOST IMPOSSIBLE!  
1 3
 0 0 0 0 0 0 0 0 0 0 0 0 0 0 0 0 0 0 0 0
 0 0 0 1 1 6 0 0 0 0 0 0 0 0 0 0 0 0 0 0
 0 1 0 0 0 1 2 2 4 0 0 0 0 0 0 0 0 1 1 1
 0 1 1 1 0 1 2 210 0 1 1 1 6 1 1 1 114 1
 0 1 0 1 1 1 1 1 1 1 1 012 0 0 0 0 1 1 1
 0 1 1 1 0 0 2 2 0 0 1 1 1 0 0 0 0 0 1 0
 0 0 1 0 0 0 2 2 0 0 0 1 0 0 0 0 0 0 1 1
 0 0 1 0 0 0 2 2 0 0 0 1 1 1 1 0 0 0 0 1
 0 0 1 1 1 1 2 2 0 0 0 1 0 0 1 0 0 1 1 1
 0 0 1 0 0 1 2 2 0 0 0 1 0 0 1 0 0 1 0 0
 0 0 1 0 0 1 2 2 0 0 0 1 0 0 1 0 0 1 1 0
 0 1 1 8 0 1 2 2 0 0 1 110 1 1 0 0 0 6 0
 0 1 0 1 1 1 1 1 1 1 1 0 1 0 0 0 0 1 1 1
 0 1 1 1 0 0 0 0 0 0 1 1 1 0 0 0 0 1 3 1
 0 1 0 0 0 0 0 0 0 0 0 0 0 0 0 0 0 1 1 1
18 13 1
6 12 0
13 11 2
4 1 3