The levels are getting harder
8 12
 0 0 0 0 0 0 0 0 0 0 0 0 0 0 0 0 0 0 0 0
 0 0 0 0 0 0 0 0 0 0 0 0 0 0 0 0 0 0 0 0
 0 0 0 0 1 1 1 2 2 2 1 1 1 0 0 0 0 0 0 0
 0 0 0 0 1 0 1 1 1 1 1 0 1 0 0 0 0 0 0 0
 0 0 0 0 1 1 1 0 1 0 1 1 1 0 0 0 0 0 0 0
 0 0 0 0 2 1 0 0 1 0 0 1 2 0 0 0 0 0 0 0
 0 0 0 0 2 1 0 0 4 0 0 1 2 0 0 0 0 0 0 0
 0 0 0 0 1 1 1 0 0 0 1 1 1 0 0 0 0 0 0 0
 0 0 0 0 1 0 1 113 1 1 0 1 0 0 0 0 0 0 0
 0 0 0 0 1 1 1 0 1 0 1 1 1 0 0 0 0 0 0 0
 0 0 0 0 0 0 0 0 1 0 0 0 0 0 0 0 0 0 0 0
 0 0 0 0 0 0 0 1 1 1 0 0 0 0 0 0 1 1 1 0
 0 0 0 0 0 0 0 1 1 1 1 115 1 1 6 1 3 1 0
 0 0 0 0 0 0 0 1 1 1 0 0 0 0 0 0 1 1 1 0
 0 0 0 0 0 0 0 0 0 0 0 0 0 0 0 0 0 0 0 0
4 2 0
12 2 1
