A great chase
1 4
 0 0 0 0 0 0 0 0 0 0 0 0 0 0 0 0 0 0 0 0
 0 0 0 0 0 0 0 0 0 0 0 0 0 0 0 0 0 0 0 0
 0 0 0 1 1 1 1 0 0 0 0 0 0 0 0 0 0 0 0 0
 0 0 0 0 0 0 1 0 0 0 0 8 0 0 0 0 0 0 0 0
 0 1 1 1 1 1 1 1 1 1 0 1 0 0 0 0 0 0 0 0
 0 0 0 0 0 1 0 1 0 1 0 1 0 0 0 0 0 0 0 0
 0 0 0 0 0 1 0 1 0 1 1 1 1 1 0 0 0 0 0 0
 0 0 0 0 0 1 1 1 0 1 0 2 0 1 0 0 0 0 0 0
 0 0 0 0 0 0 0 1 0 1 0 2 0 1 0 0 0 0 0 0
 0 0 0 0 0 0 0 1 0 1 0 2 0 1 0 0 0 0 0 0
 0 0 0 0 0 0 0 1 1 1 1 1 1 110 1 1 1 3 0
 0 0 0 0 0 0 0 1 0 0 0 1 0 0 0 0 0 0 0 0
 0 0 0 0 0 0 0 1 1 1 1 1 0 0 0 0 0 0 0 0
 0 0 0 0 0 0 0 0 0 0 0 0 0 0 0 0 0 0 0 0
 0 0 0 0 0 0 0 0 0 0 0 0 0 0 0 0 0 0 0 0
3 2 3
11 12 2