 a maze, and the first with HOSTILE echidnas
1 1
 0 0 0 0 0 0 0 0 0 0 0 0 0 0 0 0 0 0 0 0
 0 1 1 1 1 1 0 1 0 1 1 1 1 1 1 1 1 1 1 0
 0 1 0 1 0 1 0 1 0 1 0 1 0 1 0 1 0 1 0 0 
 0 1 1 1 1 0 1 1 0 1 1 1 1 0 1 1 1 1 1 0
 0 1 0 1 0 0 0 1 0 1 0 1 0 1 0 0 0 1 0 0 
 0 1 1 1 1 1 1 1 1 1 0 1 1 8 1 0 1 1 1 0
 0 1 0 1 0 1 0 1 0 1 0 1 0 1 0 1 0 1 0 0 
 0 1 1 0 1 1 1 1 1 0 1 1 1 1 1 1 0 1 0 0
 0 1 0 1 0 1 0 1 0 1 0 1 0 0 0 1 0 1 0 0 
 0 0 1 1 1 0 1 1 1 1 1 1 1 1 1 0 1 1 1 0
 0 1 0 1 0 1 0 1 0 0 0 0 0 0 0 1 1 1 0 0 
 0 1 1 1 0 1 1 0 1 110 1 1 1 1 1 0 0 1 0
 0 1 0 1 0 1 0 1 0 1 010 0 0 0 0 0 1 0 0 
 0 1 1 1 1 1 0 1 1 0 1 1 1 1 1 1 1 1 3 0
 0 0 0 0 0 0 0 0 0 0 0 0 0 0 0 0 0 0 0 0
15 3 1
3 3 0
9 11 2
