The second last level
1 1
 0 0 0 0 0 0 0 0 0 0 0 0 0 0 0 0 0 0 0 0
 0 1 1 1 1 1 1 1 0 0 1 1 1 1 1 1 114 3 0
 0 1 0 1 0 1 0 1 0 0 1 0 1 0 1 0 1 0 1 0
 0 1 1 1 1 1 1 1 0 0 1 1 1 1 1 1 1 1 1 0
 0 1 0 1 0 1 0 1 0 0 1 0 1 014 0 1 0 1 0
 0 1 1 1 1 114 1 0 0 1 1 1 1 1 1 1 112 0
 0 1 0 1 0 1 0 1 0 0 1 0 1 0 1 0 1 0 1 0
 012 1 1 1 1 1 1 0 0 1 1 1 1 1 1 1 1 1 0
 0 1 014 0 1 0 1 0 012 0 1 0 1 0 1 0 1 0
 0 1 1 1 1 1 1 1 0 0 1 1 1 1 1 1 1 1 1 0
 0 1 0 1 0 1 0 1 0 0 1 0 1 0 1 0 1 0 1 0
 0 1 1 1 1 1 1 1 0 0 1 1 1 1 1 1 1 1 1 0
 014 0 1 0 1 0 1 0 0 1 0 1 0 1 0 1 0 1 0
 0 1 1 1 1 1 1 114 1 114 1 1 1 1 114 1 0
 0 0 0 0 0 0 0 0 0 0 0 0 0 0 0 0 0 0 0 0
3 2 3
11 13 2
5 9 0
11 11 2
11 5 1
11 7 1